																		1		1
																		1		1
												1						1	7	1
												1								1
										1		1					1			1
										1			1				1			1
									1				1				1			1
									1											1
									1						1					1
								12	1						1					1
							1	1	1											1
						1	1	1											12	1
1	1	1	1	1	1	1	1													1
																				1
																				1
																				1
																				1
																				1
																				1
